  11111
  10101
  10101
 1111111
 1 1 1 1