  11111
  10101
  10X01
 1111111
 1 1 1 1